NO     ./bitmaps/north_test.xpm       
 SO  ./bitmaps/south_test.xpm 
 
WE ./bitmaps/west_test.xpm    
EA ./bitmaps/east_test.xpm       

F 160,160,160
C 0,128,255

        1111111111111111111111111
        1000000000110000000000001
        1011000001110000000000001
        100100000000000000000000111111111
        111111111011000001110000000000001
        100000000011000001110111111111111
        11110111111111011100000010001
        11110111111111011101010010001
        11000000110101011100000010001
        10000000000000001100000010001
1111111110000E00000000001101010000001
1100000111010101111101111000111111111
11110111 1110101 1011110100011
11111111 1111111 111111111111