NO ./cub3d.h
SO ./cub3d.h
WE ./cub3d.h
EA ./cub3d.h

F      160,160,160
C 0,128 , 255

11111111
11111001111
10000000001
10000N00001
10000001001
11111111111
1
11111111