NO     ./test.xpm      
 SO  ./test.xpm 
 
WE ./test.xpm 
EA ./test.xpm 

F 160,160,160 
C  255 , 0 , 255 ,


11111111
11111001111
10000000001
10000N00001
10000001001
11111111111
1
11111111