NO     ./bitmaps/north_test.xpm     
 SO  ./bitmaps/south_test.xpm
 
WE ./bitmaps/west_test.xpm 
EA ./bitmaps/east_test.xpm

F 0,0,255 
C  255,0,0


11111111
11111001111
10000000001
10000N00001
10000001001
11111111111
1
11111111